X X X X X X X X X X
X 0 P P P P P P P X
X 0 0 0 0 0 0 0 P X
X 0 0 W W W W 0 P X
X 0 0 F 0 F 0 0 P X
X 0 0 0 F 0 F 0 P 2
X 0 0 W W W W 0 0 X
X 0 0 0 0 0 0 0 0 X
X 0 0 0 0 0 0 0 0 X
X X X X X X X X X X