X X X X 2 X X X X X
X E 0 0 0 0 0 0 E X
X 0 W 0 0 0 0 W 0 X
X 0 0 W 0 0 W 0 0 X
X 0 P P W W P P 0 X
X 0 P F F F F P 0 X
X 0 0 P F F P 0 0 X
X 0 0 0 P P 0 0 0 X
X 0 0 0 0 0 0 0 0 X
X X X X X X X X X X